######                                        #
#      017       002       014--020      #
#       |         |         |    |       #
#       |         |         |    |       #
#      016--015--001--012--013--018--019 #
#                 |                      #
#                 |                      #
#      008--007--000--003--004           #
#       |         |                      #
#       |         |                      #
#      009       005                     #
#       |         |                      #
#       |         |                      #
#      010--011--006                     #
#                                        #
#####